000000000000000000000000000000
000000000000000000000000000000
000000000000000000000000000000
000000000000000000000000000000
000000000000000000000000000000
0000000000000WWWWW000000000000
WWWWWWWWWWWWWSSSSSWWWWWWWWWWWW
00000000000000000000000000000G
0000000000000000000000000C0000
00P00000000000000000H0000C0D00
0000000000000000000000000C0000
00000000000000000000000000000G
WWWWWWWWWWWWWAAAAAWWWWWWWWWWWW
0000000000000WWWWW000000000000
000000000000000000000000000000
000000000000000000000000000000
000000000000000000000000000000
000000000000000000000000000000
000000000000000000000000000000