0WSW000W00000000000000M0000000
00M0000W0WWWWWWHWWWWWWWWWWW#WW
0000000W000m000W00000000000000
000000MW000m000W00000000000000
0000000WWWWWWW0WWW000000000000
0000000000000W0WBW000000000000
0000000000000W0WAW000000000000
0000000000000W00mW000000000000
0000000000M00WWWW0000000000000
000000000000000000000000000000
0000000000000000000000M0000000
000000000000000000000000000000
0000000000000000M0000000000000
0M0000000000000000000000000000
000000000000000000000000000000
0000000000000000000000000WWW0W
0000000000000000000000000W0000
W00000000000WmW0000000000W00P0
G#0000000000WCW0000000000WHHHH