000000000000WWWWWWW00000000000
000000000000W00B00W00000000000
000000000000W0G0G0W00000000000
000000000000WWW0WWW00000000000
00000000000000W0W0000000000000
00WWWWWWW00000W#W00000WWWWWWW0
00W00000W00000W#W00000W00000W0
00W00M00W00000W#W00000W00M00W0
00W00000W00000W0W00000W00000W0
00W00000WWWWWWW0WWWWWWW00000W0
00WHA000m000000P000000m000SHW0
00W00000WWWWWWW0WWWWWWW00000W0
00W00000W00000W0W00000W00000W0
00W00M00W00000W0W00000W00M00W0
00W00000W00000W0W00000W00000W0
00WWWWWWW00000W0W00000WWWWWWW0
00000000000000W#W0000000000000
00000000000000WCW0000000000000
00000000000000W0W0000000000000