0000000BWH000MWW00000000000000
0WWHWWWWW0WWW00WW0000000000000
00M00000W0W0WW00WW000000000000
WWWWWWW0W0W00WW00WW00000000000
G0000000W0W000WW00WW0000000000
WWWWWWW0W0W0000WW00WW000000000
00M00000W0W00000WW00WW00000000
0WWWWWWWW0W000000WW00WW0000000
0000000AW0W0000000WW00WW000000
0WWWWWWWW0W00000000WW00WW00000
00M00000W0W000000000WW00WW0000
WWWWWWW0W0W0000000000WW00WW000
S0000000W0W00000000000WW00WW00
WWWWWWW0WMW000000000000WW0MWW0
00M00000W0W0000000000000WW00WW
0WWWWWW0W0W00000000000000WW00W
0WC00000W0W000000000000000WW0m
0WWWWWWWW0W0000000000000000WW0
00000000#0W00000000000000000WP