000000000000000000000000000000
00P0000000000M000M00000M000000
000000000000000000000000000000
WWWWWWWWWWWWWWWWWWWWWWWWWWW0M0
00000000000000000000000000W000
00000000000000000000000000W000
WWWWWWWWWWWWWWWWWWWWWWWWWWW000
000M0000000M000000000M000000M0
000000000000000000000000000000
0M0WWWWWWWWWWWWWWWWWWWWWWWWWWW
000W00000000000000000000000000
000W00000000000000000000000000
000WWWWWWWWWWWWWWWWWWWWWWWWWWW
000000000000000000000000000000
00M00000000M0000000M000000M000
WWWWWWWWWWWWWWWWWWWWWWWWWWW0M0
#0H000000000000000000000000000
B000000M00000M000000M000000M00
#0H000000000000000000000000000