000000000000WC0CW0000000000000
000000000000WS0AW0000000000000
000000000000W000W0000000000000
000000000000W000W0000000000000
000000000000W000W0000000000000
000000000000W000W0000000000000
000000000000W000W0000000000000
WWWWWWWWWWWWW#B#WWWWWWWWWWWWWW
000000000000000000000000000000
00M00M00M00M00P00M00M00M00M000
000000000000000000000000000000
WWWWWWWWWWWWW###WWWWWWWWWWWWWW
000000000000W000W0000000000000
000000000000W000W0000000000000
000000000000W000W0000000000000
000000000000W000W0000000000000
000000000000W000W0000000000000
000000000000WG0GW0000000000000
000000000000W0H0W0000000000000