000000000000000000000000000000
00000000000WWWWWWWWW00000000C0
00000000000W0000000W00000000C0
00000000000W0000M00W00000000C0
WWWWWWWWWWW000000000WWWWWWWWC0
0P0000HA000000000000000000MBC0
WWWW0WWWWWW000000000WWWWWWWWC0
000W0W00000W0000M00W00000000C0
000WmW00000W0M00000W00000000C0
000WSW00000W0000000W00000000C0
0000W0000000WWWWWWW00000000000
000000000000000000000000000000
000000000000000000000000000000
000000000000000000000000000000
000000000000000000000000000000
000000000000000000000000000000
000000000000000000000000000000
000000000000000000000000000000
000000000000000000000000000000