00000000000000000000W00000W0W0
00000000000000000000W0WWW0WPW0
00000000000000000000W0W0W0W0W0
00000000000000000000W0W0WMW0W0
00000000000000000000W0W0W0W0W0
00000000000000000000WMW0W0W0W0
WWW00000000000000000W0W0W0W0W0
WBW00000000000000000W0W0W0W0W0
W00W0000000000000000W0W0W0W0W0
W000W000000000000000W0W0W0W0W0
W0000W00000000000000W0W0W0W0W0
W00000W0000000000000W0W0W0W0W0
W000000W000000000000W0W0W0W0W0
W0000000W00000W00000W0W0W0W0W0
W00000000W000WSW0000W0W0W0W0W0
W000000000W00WmW0000W0W0W0W0W0
WWWW0000000WWW0WWWWWW0W0W0WMW0
WHC#M0000000000000000HWWW0W0W0
WWWW0000000000000000000CW000W0